%%%%%%%%%%
%.P... G %
%%%%%%%%%%
