%%%%%%%%%%
%.P.   G %
%%%%%%%%%%
