%%%%%%%%%%%
%....G....%
%.%%.%.%%.%
%.%o......%
%.%%.%.%%.%
%........P%
%%%%%%%%%%%
