%%%%%%%%%%%
%....G..G.%
%.%%.%.%%.%
%.%o......%
%.%%.%.%%.%
%........P%
%%%%%%%%%%%
